11111111111111111111111111111111111
1E00000000000C1C001001000001C101011
111C0001111110010101011000000101011
10010000000000010010111001110010111
11101011100110001010000011100010101
110111111010100000000C1011100011011
10101011111010001111001010010101001
11010011001000011110110011000000011
111C0000000000010011001010010001011
11110011101010000000000000000001101
11110010001101100100110011000111101
100C0000000000000000000000000000011
11000100101000110000000111000000P01
10011101001111000111001000010101011
11111111111111111111111111111111111