11111111111111111111111111111111111111
1P000000000000000000000000000000000001
100011111111000CCCCCCCC000111111110001
100011111111000CCCCCCCC000111111110001
100000011000000000CC000000000110000001
100000011000000000CC000000000110000001
100000011000000000CC000000000110000001
100000011000000000CC000000000110000001
100011111111000CCCCCCCC000111111110001
100011111111000CCCCCCCC000111111110001
100000000000000000000000000000000000E1
11111111111111111111111111111111111111