111111111111111111111111111111111111111111111
1P0000000000000000C00111001101100010C00110011
100C00001001101000011101101101001111011100111
100100000000000001110000100011111110011111111
101101101110000000101100011011010110000001101
101001110101001100000000000C11000111011100101
111010111011001101001111100101111000010000101
111100111010011001001010001011110110010011001
1001C0000000000000001111101110100010000000011
111010001100010100000000000000000000001111111
100000100111101111111100000110100000010010101
1100C000000000000000000000000000000000000C111
1010000110001100001110010111010110000000000E1
111110000110110000010101010011001010001111011
111111111111111111111111111111111111111111111