1111111111111111111111111111111111
1P00000000000000000000000000000001
11111111000CCCCCCCCC00000000000001
11111111000CCCCCCCCC00000000000001
11111111000CCCCCCCCC00000000000001
1000000000000011100000000000000001
1111111111000011100000000000000001
1111111111000011100000000000000001
1111111111000011100000000000000001
11111111110CC111111100000000000001
10000000000CC00E1CCC00000000000001
11100000000CC111111100000000000001
1110000000000000000000000000000001
1111111111111111111111111111111111